#hypernode nodes
Demethylated_methyl_acceptors	Demethylated_methyl_acceptors
RNASE_E_PROCESSING_PRODUCT_MRNA	RNASE_E_PROCESSING_PRODUCT_MRNA
SUC_COA	SUC_COA
AMMONIUM	AMMONIUM
S_ADENOSYL_4_METHYLTHIO_2_OXOBUTANOATE	S_ADENOSYL_4_METHYLTHIO_2_OXOBUTANOATE
PHOSPHORIBOSYL_AMP	PHOSPHORIBOSYL_AMP
Charged_ASP_tRNAs	Charged_ASP_tRNAs
ACET	ACET
DEAMIDO_NAD	DEAMIDO_NAD
DIHYDROPTERIN_CH2OH_PP	DIHYDROPTERIN_CH2OH_PP
_23S_rRNA_pseudouridine955_2504_2580	_23S_rRNA_pseudouridine955_2504_2580
FORMYL_L_METHIONYL_PEPTIDE	FORMYL_L_METHIONYL_PEPTIDE
DETHIOBIOTIN	DETHIOBIOTIN
PYRIDOXINE	PYRIDOXINE
AMINO_OH_HYDROXYMETHYL_DIHYDROPTERIDINE	AMINO_OH_HYDROXYMETHYL_DIHYDROPTERIDINE
RNASE_E_MRNA_PROCESSING_SUBSTRATE	RNASE_E_MRNA_PROCESSING_SUBSTRATE
_3_Oxo_octanoyl_ACPs	_3_Oxo_octanoyl_ACPs
Octanoylated_domains	Octanoylated_domains
VAL	VAL
ADENOSYL_HOMO_CYS	ADENOSYL_HOMO_CYS
Sulfur_Carrier_Proteins_ThiI	Sulfur_Carrier_Proteins_ThiI
N_ACETYL_D_GLUCOSAMINE_1_P	N_ACETYL_D_GLUCOSAMINE_1_P
CPD_2961	CPD_2961
FORMALDEHYDE	FORMALDEHYDE
mRNAs_with_5_monophosphate	mRNAs_with_5_monophosphate
DEPHOSPHO_COA	DEPHOSPHO_COA
GLUTAMATE_1_SEMIALDEHYDE	GLUTAMATE_1_SEMIALDEHYDE
AMINO_HYDROXYMETHYL_METHYL_PYR_P	AMINO_HYDROXYMETHYL_METHYL_PYR_P
CPD0_1422	CPD0_1422
_10_FORMYL_THF	_10_FORMYL_THF
_3_P_HYDROXYPYRUVATE	_3_P_HYDROXYPYRUVATE
WATER	WATER
tRNAs	tRNAs
Sugar_Phosphate	Sugar_Phosphate
Deoxy_Ribonucleoside_Diphosphates	Deoxy_Ribonucleoside_Diphosphates
PRPP	PRPP
THZ_P	THZ_P
Damaged_DNA	Damaged_DNA
Reduced_NrdH_Proteins	Reduced_NrdH_Proteins
_4_CYTIDINE_5_DIPHOSPHO_2_C	_4_CYTIDINE_5_DIPHOSPHO_2_C
D_SEDOHEPTULOSE_7_P	D_SEDOHEPTULOSE_7_P
D_ERYTHRO_IMIDAZOLE_GLYCEROL_P	D_ERYTHRO_IMIDAZOLE_GLYCEROL_P
THYMIDINE	THYMIDINE
Myristoyl_ACPs	Myristoyl_ACPs
DGTP	DGTP
PYRIDOXAL	PYRIDOXAL
Decanoyl_ACPs	Decanoyl_ACPs
Charged_THR_tRNAs	Charged_THR_tRNAs
BIOTIN	BIOTIN
CPD_7046	CPD_7046
Ox_Thioredoxin	Ox_Thioredoxin
CMP	CMP
CPD_8181	CPD_8181
CPD_8180	CPD_8180
N_Substituted_Amino_Acids	N_Substituted_Amino_Acids
tRNA_Holder	tRNA_Holder
CPD0_1699	CPD0_1699
TTP	TTP
CPD_8624	CPD_8624
CPD_8625	CPD_8625
RIBOFLAVIN	RIBOFLAVIN
Octadec_2_enoyl_ACPs	Octadec_2_enoyl_ACPs
CPD0_1456	CPD0_1456
FE_2	FE_2
FE_3	FE_3
CPD0_1108	CPD0_1108
DsrEFH_Persulfides	DsrEFH_Persulfides
b_Hydroxy_cis_D5_dodecenoyl_ACPs	b_Hydroxy_cis_D5_dodecenoyl_ACPs
ACYL_ACP	ACYL_ACP
DIHYDROXY_ACETONE_PHOSPHATE	DIHYDROXY_ACETONE_PHOSPHATE
L_PANTOATE	L_PANTOATE
AICAR	AICAR
XANTHOSINE_5_PHOSPHATE	XANTHOSINE_5_PHOSPHATE
OROTIDINE_5_PHOSPHATE	OROTIDINE_5_PHOSPHATE
Charged_TYR_tRNAs	Charged_TYR_tRNAs
_3_MERCAPTO_PYRUVATE	_3_MERCAPTO_PYRUVATE
_3OH_4P_OH_ALPHA_KETOBUTYRATE	_3OH_4P_OH_ALPHA_KETOBUTYRATE
D_ALANINE	D_ALANINE
Saturated_Fatty_Acyl_ACPs	Saturated_Fatty_Acyl_ACPs
PROTEIN_LIPOYLLYSINE	PROTEIN_LIPOYLLYSINE
CPD_12231	CPD_12231
THYMINE	THYMINE
_4_PHOSPHONOOXY_THREONINE	_4_PHOSPHONOOXY_THREONINE
_5_PHOSPHORIBOSYL_5_AMINOIMIDAZOLE	_5_PHOSPHORIBOSYL_5_AMINOIMIDAZOLE
_3_oxo_stearoyl_ACPs	_3_oxo_stearoyl_ACPs
Thi_S	Thi_S
_2R_HYDROPEROXY_FATTY_ACIDS	_2R_HYDROPEROXY_FATTY_ACIDS
Deoxynucleotides	Deoxynucleotides
_5_METHYL_THF	_5_METHYL_THF
GLN	GLN
Reduced_flavodoxins	Reduced_flavodoxins
PHENYL_PYRUVATE	PHENYL_PYRUVATE
SULFATE	SULFATE
L_rhamnose	L_rhamnose
GLY	GLY
UDP_AAGM_DIAMINOHEPTANEDIOATE	UDP_AAGM_DIAMINOHEPTANEDIOATE
L_1_PHOSPHATIDYL_GLYCEROL	L_1_PHOSPHATIDYL_GLYCEROL
GLT	GLT
P_RIBOSYL_4_SUCCCARB_AMINOIMIDAZOLE	P_RIBOSYL_4_SUCCCARB_AMINOIMIDAZOLE
HYDROXY_METHYL_BUTENYL_DIP	HYDROXY_METHYL_BUTENYL_DIP
ACETYL_P	ACETYL_P
Charged_ILE_tRNAs	Charged_ILE_tRNAs
DIACYLGLYCEROL	DIACYLGLYCEROL
Protein_Red_Disulfides	Protein_Red_Disulfides
_3_P_SERINE	_3_P_SERINE
_3_DEOXY_D_ARABINO_HEPTULOSONATE_7_P	_3_DEOXY_D_ARABINO_HEPTULOSONATE_7_P
RNASE_III_PROCESSING_PRODUCT_MRNA	RNASE_III_PROCESSING_PRODUCT_MRNA
Acceptor	Acceptor
CPD0_2472	CPD0_2472
Charged_PRO_tRNAs	Charged_PRO_tRNAs
DsrC_sulfur_carrier_proteins	DsrC_sulfur_carrier_proteins
CPD0_2354	CPD0_2354
TusE_S_sulfanylcysteine	TusE_S_sulfanylcysteine
RNASE_E_DEGRADATION_SUBSTRATE_MRNA	RNASE_E_DEGRADATION_SUBSTRATE_MRNA
OXALACETIC_ACID	OXALACETIC_ACID
RIBOSE	RIBOSE
CPD0_2352	CPD0_2352
FMN	FMN
NICOTINAMIDE_NUCLEOTIDE	NICOTINAMIDE_NUCLEOTIDE
URIDINE	URIDINE
GLYCEROL_3P	GLYCEROL_3P
CPD0_2350	CPD0_2350
R_3_hydroxyhexanoyl_ACPs	R_3_hydroxyhexanoyl_ACPs
PYRIDOXAMINE	PYRIDOXAMINE
tRNAs_with_queuosine	tRNAs_with_queuosine
URACIL	URACIL
DIHYDRO_NEO_PTERIN	DIHYDRO_NEO_PTERIN
tRNA_precursors	tRNA_precursors
Protein_L_glutamine	Protein_L_glutamine
Single_Stranded_DNAs	Single_Stranded_DNAs
HYDROGEN_PEROXIDE	HYDROGEN_PEROXIDE
CPD_536	CPD_536
Oxidized_flavodoxins	Oxidized_flavodoxins
DNA_Combined_With_Exogenous_DNA	DNA_Combined_With_Exogenous_DNA
CPD_653	CPD_653
CPD0_2353	CPD0_2353
DATP	DATP
CPD0_2351	CPD0_2351
RIBOSE_1P	RIBOSE_1P
DPG	DPG
_2_AMINO_3_OXO_4_PHOSPHONOOXYBUTYRATE	_2_AMINO_3_OXO_4_PHOSPHONOOXYBUTYRATE
PROPIONATE	PROPIONATE
PHOSPHORIBOSYL_ATP	PHOSPHORIBOSYL_ATP
L_PHOSPHATIDATE	L_PHOSPHATIDATE
L_KYNURENINE	L_KYNURENINE
DIAMINO_OH_PHOSPHORIBOSYLAMINO_PYR	DIAMINO_OH_PHOSPHORIBOSYLAMINO_PYR
_23S_rRNA_pseudouridine1911_1915_1917	_23S_rRNA_pseudouridine1911_1915_1917
Peptidoglycans	Peptidoglycans
_2_PG	_2_PG
AP_Site_Created	AP_Site_Created
PRO_tRNAs	PRO_tRNAs
_2_Acylglycero_Phosphocholines	_2_Acylglycero_Phosphocholines
PHOSPHATIDYLCHOLINE	PHOSPHATIDYLCHOLINE
G3P	G3P
CARBAMOYL_P	CARBAMOYL_P
Nucleoside_Diphosphates	Nucleoside_Diphosphates
Oligonucleotides	Oligonucleotides
URATE	URATE
HIS	HIS
apo_ACP	apo_ACP
Charged_ALA_tRNAs	Charged_ALA_tRNAs
Guanine34_in_tRNA_with_GUN_anticodon	Guanine34_in_tRNA_with_GUN_anticodon
Resolution_of_Recombinational_Junction	Resolution_of_Recombinational_Junction
L_Cysteine_Desulfurases	L_Cysteine_Desulfurases
UDP	UDP
Red_Thioredoxin	Red_Thioredoxin
R_3_hydroxyarachidoyl_ACPs	R_3_hydroxyarachidoyl_ACPs
Non_lipoylated_domains	Non_lipoylated_domains
PHOSPHORIBOSYL_FORMIMINO_AICAR_P	PHOSPHORIBOSYL_FORMIMINO_AICAR_P
FRU1P	FRU1P
Protein_Histidines	Protein_Histidines
Pyruvate_dehydrogenase_dihydrolipoate	Pyruvate_dehydrogenase_dihydrolipoate
BCAA_dehydrogenase_lipoyl	BCAA_dehydrogenase_lipoyl
_2_PHOSPHO_4_CYTIDINE_5_DIPHOSPHO_2_C_MET	_2_PHOSPHO_4_CYTIDINE_5_DIPHOSPHO_2_C_MET
Charged_VAL_tRNAs	Charged_VAL_tRNAs
THR_tRNAs	THR_tRNAs
ADENOSINE	ADENOSINE
SUPER_OXIDE	SUPER_OXIDE
ssRNAs	ssRNAs
Protein_3_phospho_L_histidines	Protein_3_phospho_L_histidines
PRO	PRO
GLYCOLALDEHYDE	GLYCOLALDEHYDE
_23S_rRNA_2_O_methyluridine2552	_23S_rRNA_2_O_methyluridine2552
THIAMINE_P	THIAMINE_P
CPD_12261	CPD_12261
Hexanoyl_ACPs	Hexanoyl_ACPs
IMINOASPARTATE	IMINOASPARTATE
OXYGEN_MOLECULE	OXYGEN_MOLECULE
PHENYLACETATE	PHENYLACETATE
DEOXY_RIBOSE_1P	DEOXY_RIBOSE_1P
Apo_GcvH	Apo_GcvH
Peptides_with_Leader_Sequence	Peptides_with_Leader_Sequence
METHYLENE_THF	METHYLENE_THF
Fatty_Acids	Fatty_Acids
N_formyl_L_methionyl_tRNAfmet	N_formyl_L_methionyl_tRNAfmet
D_ALA_D_ALA	D_ALA_D_ALA
Trans_D2_hexacos_2_enoyl_ACPs	Trans_D2_hexacos_2_enoyl_ACPs
_9S_RRNA	_9S_RRNA
tRNA_uridine_38_40	tRNA_uridine_38_40
APS	APS
L_1_PHOSPHATIDYL_ETHANOLAMINE	L_1_PHOSPHATIDYL_ETHANOLAMINE
Thiocarboxyadenylated_ThiS_Proteins	Thiocarboxyadenylated_ThiS_Proteins
ACETALD	ACETALD
S_ACETYLDIHYDROLIPOAMIDE	S_ACETYLDIHYDROLIPOAMIDE
Trans_D3_cis_D9_hexadecenoyl_ACPs	Trans_D3_cis_D9_hexadecenoyl_ACPs
TYR	TYR
mRNAs	mRNAs
_3_oxo_cis_vaccenoyl_ACPs	_3_oxo_cis_vaccenoyl_ACPs
Protein_With_N_Terminal_Met	Protein_With_N_Terminal_Met
apolipoprotein	apolipoprotein
Beta_3_hydroxybutyryl_ACPs	Beta_3_hydroxybutyryl_ACPs
_2_3_4_Saturated_L_Phosphatidates	_2_3_4_Saturated_L_Phosphatidates
ETOH	ETOH
_3_oxo_myristoyl_ACPs	_3_oxo_myristoyl_ACPs
FUM	FUM
PAPS	PAPS
_4_AMINO_4_DEOXYCHORISMATE	_4_AMINO_4_DEOXYCHORISMATE
TRANS_D2_ENOYL_ACP	TRANS_D2_ENOYL_ACP
DIHYDROLIPOAMIDE	DIHYDROLIPOAMIDE
IMIDAZOLE_ACETOL_P	IMIDAZOLE_ACETOL_P
_2_DEHYDROPANTOATE	_2_DEHYDROPANTOATE
HMP	HMP
N_6_ISOPENTYL_ADENOSINE_37_TRNA	N_6_ISOPENTYL_ADENOSINE_37_TRNA
ADENOSYL_P4	ADENOSYL_P4
Pimeloyl_ACPs	Pimeloyl_ACPs
_16S_rRNA_adenine1518_adenine1519	_16S_rRNA_adenine1518_adenine1519
RIBOSE_5P	RIBOSE_5P
S2O3	S2O3
BCCP_dimers	BCCP_dimers
_1_PALMITOYLGLYCEROL_3_PHOSPHATE	_1_PALMITOYLGLYCEROL_3_PHOSPHATE
Reduced_Quinones	Reduced_Quinones
Double_Stranded_DNAs	Double_Stranded_DNAs
HOMO_CYS	HOMO_CYS
CPD_13043	CPD_13043
TRP_tRNAs	TRP_tRNAs
PANTETHEINE_P	PANTETHEINE_P
QUINOLINATE	QUINOLINATE
Diacylglycerol_Prolipoproteins	Diacylglycerol_Prolipoproteins
E_	E_
CPD_7670	CPD_7670
_23S_rRNA_uridine1911_1915_1917	_23S_rRNA_uridine1911_1915_1917
DsrEFH_Complexes	DsrEFH_Complexes
_5_AMINO_LEVULINATE	_5_AMINO_LEVULINATE
R_3_hydroxydodecanoyl_ACPs	R_3_hydroxydodecanoyl_ACPs
SO3	SO3
MAL	MAL
UNDECAPRENYL_DIPHOSPHATE	UNDECAPRENYL_DIPHOSPHATE
Charged_MET_tRNAs	Charged_MET_tRNAs
CARBON_MONOXIDE	CARBON_MONOXIDE
Lipoyl_Protein	Lipoyl_Protein
_5_P_BETA_D_RIBOSYL_AMINE	_5_P_BETA_D_RIBOSYL_AMINE
Acetoacetyl_ACPs	Acetoacetyl_ACPs
AMMONIA	AMMONIA
CARDIOLIPIN	CARDIOLIPIN
LIPOAMIDE	LIPOAMIDE
tRNA_pseudouridine_38_40	tRNA_pseudouridine_38_40
Charged_CYS_tRNAs	Charged_CYS_tRNAs
DELTA3_ISOPENTENYL_PP	DELTA3_ISOPENTENYL_PP
THIAMINE	THIAMINE
AMINOMETHYLDIHYDROLIPOYL_GCVH	AMINOMETHYLDIHYDROLIPOYL_GCVH
ATP	ATP
tRNAs_containing_epoxy_quenosine	tRNAs_containing_epoxy_quenosine
_2C_METH_D_ERYTHRITOL_CYCLODIPHOSPHATE	_2C_METH_D_ERYTHRITOL_CYCLODIPHOSPHATE
PHOSPHATIDYL_MYO_INOSITOL_45_BISPHOSPHA	PHOSPHATIDYL_MYO_INOSITOL_45_BISPHOSPHA
General_Protein_Substrates	General_Protein_Substrates
FMNH2	FMNH2
SER	SER
CPD_1302	CPD_1302
Palmitoleoyl_ACPs	Palmitoleoyl_ACPs
R_3_hydroxybehenoyl_ACPs	R_3_hydroxybehenoyl_ACPs
GLC_6_P	GLC_6_P
_7_8_DIHYDROPTEROATE	_7_8_DIHYDROPTEROATE
Cis_delta_3_decenoyl_ACPs	Cis_delta_3_decenoyl_ACPs
Glutaryl_ACP_methyl_esters	Glutaryl_ACP_methyl_esters
Fatty_Aldehydes	Fatty_Aldehydes
ASN	ASN
_23S_rRNA_uridine_2552	_23S_rRNA_uridine_2552
Relaxed_DNAs	Relaxed_DNAs
Reduced_ferredoxins	Reduced_ferredoxins
NAD_P_OR_NOP	NAD_P_OR_NOP
GTP	GTP
GERANYL_PP	GERANYL_PP
DIMETHYL_D_RIBITYL_LUMAZINE	DIMETHYL_D_RIBITYL_LUMAZINE
FRU	FRU
Charged_PHE_tRNAs	Charged_PHE_tRNAs
MALONYL_COA	MALONYL_COA
HOMO_SER	HOMO_SER
Pyruvate_dehydrogenase_lipoate	Pyruvate_dehydrogenase_lipoate
Lysidine_tRNA_Ile2	Lysidine_tRNA_Ile2
_3_Ketopimeloyl_ACP_methyl_esters	_3_Ketopimeloyl_ACP_methyl_esters
Nucleoside_Monophosphates	Nucleoside_Monophosphates
_2_KETO_ISOVALERATE	_2_KETO_ISOVALERATE
PALMITATE	PALMITATE
_3_Hydroxy_Terminated_DNAs	_3_Hydroxy_Terminated_DNAs
Protein_Ox_Disulfides	Protein_Ox_Disulfides
SN_GLYCEROL_1_PHOSPHATE	SN_GLYCEROL_1_PHOSPHATE
tRNA_2_thiouridine34	tRNA_2_thiouridine34
CPD_4211	CPD_4211
CYS	CYS
Carboxylates	Carboxylates
SIROHEME	SIROHEME
ACETYLSERINE	ACETYLSERINE
_3_Hydroxy_octanoyl_ACPs	_3_Hydroxy_octanoyl_ACPs
_2_Lysophosphatidylcholines	_2_Lysophosphatidylcholines
D_GLT	D_GLT
CPD0_1905	CPD0_1905
_3_oxo_cis_D9_hexadecenoyl_ACPs	_3_oxo_cis_D9_hexadecenoyl_ACPs
D_GLUCOSAMINE_6_P	D_GLUCOSAMINE_6_P
CPD_13575	CPD_13575
CH33ADO	CH33ADO
ADENYLOSUCC	ADENYLOSUCC
tRNA_Ile2	tRNA_Ile2
Negatively_super_coiled_DNAs	Negatively_super_coiled_DNAs
OLIGOPEPTIDES	OLIGOPEPTIDES
LYS_tRNAs	LYS_tRNAs
Leader_Sequences	Leader_Sequences
Cis_Delta5_dodecenoyl_ACPs	Cis_Delta5_dodecenoyl_ACPs
RNASE_II_SUBSTRATE_WITH_NO_POLY_A_TAIL	RNASE_II_SUBSTRATE_WITH_NO_POLY_A_TAIL
_23S_rRNA_uridine955_2504_2580	_23S_rRNA_uridine955_2504_2580
_2_ALPHA_HYDROXYETHYL_THPP	_2_ALPHA_HYDROXYETHYL_THPP
tRNA_uridine55	tRNA_uridine55
_3_Ketoglutaryl_ACP_methyl_ester	_3_Ketoglutaryl_ACP_methyl_ester
Long_Chain_Polyphosphate	Long_Chain_Polyphosphate
IMP	IMP
R_4_PHOSPHOPANTOTHENOYL_L_CYSTEINE	R_4_PHOSPHOPANTOTHENOYL_L_CYSTEINE
Ribonucleoside_Monophosphates	Ribonucleoside_Monophosphates
CPD_11770	CPD_11770
Oxo_glutarate_dehydrogenase_DH_lipoyl	Oxo_glutarate_dehydrogenase_DH_lipoyl
CPD_9646	CPD_9646
DUDP	DUDP
L_seryl_SEC_tRNAs	L_seryl_SEC_tRNAs
L_GAMMA_GLUTAMYLCYSTEINE	L_GAMMA_GLUTAMYLCYSTEINE
DsrC_persulfides	DsrC_persulfides
Deoxy_Ribonucleoside_Triphosphates	Deoxy_Ribonucleoside_Triphosphates
FORMATE	FORMATE
_8_AMINO_7_OXONONANOATE	_8_AMINO_7_OXONONANOATE
SIROHYDROCHLORIN	SIROHYDROCHLORIN
PROPIONYL_COA	PROPIONYL_COA
PHOSPHORYL_CHOLINE	PHOSPHORYL_CHOLINE
_3_5_ADP	_3_5_ADP
DNA_with_Holiday_Junctions	DNA_with_Holiday_Junctions
ILE_tRNAs	ILE_tRNAs
CO_A	CO_A
GMP	GMP
Trans_D2_decenoyl_ACPs	Trans_D2_decenoyl_ACPs
AMINO_RIBOSYLAMINO_1H_3H_PYR_DIONE	AMINO_RIBOSYLAMINO_1H_3H_PYR_DIONE
Menaquinols	Menaquinols
HYDROGEN_MOLECULE	HYDROGEN_MOLECULE
Oxo_glutarate_dehydrogenase_lipoyl	Oxo_glutarate_dehydrogenase_lipoyl
HISTIDINOL	HISTIDINOL
b_Keto_cis_D5_dodecenoyl_ACPs	b_Keto_cis_D5_dodecenoyl_ACPs
DCMP	DCMP
TYR_tRNAs	TYR_tRNAs
UDP_AA_GLUTAMATE	UDP_AA_GLUTAMATE
HSO3	HSO3
L_ALPHA_ALANINE	L_ALPHA_ALANINE
METHIONYL_PEPTIDE	METHIONYL_PEPTIDE
METOH	METOH
Trans_D3_cis_D7_tetradecenoyl_ACPs	Trans_D3_cis_D7_tetradecenoyl_ACPs
D_LACTATE	D_LACTATE
THR	THR
Oxidized_NrdH_Proteins	Oxidized_NrdH_Proteins
Peptides	Peptides
Charged_ASN_tRNAs	Charged_ASN_tRNAs
DIHYDRONEOPTERIN_P	DIHYDRONEOPTERIN_P
THF_GLU_N	THF_GLU_N
THF	THF
Short_RNA_Fragments	Short_RNA_Fragments
ALPHA_GLC_6_P	ALPHA_GLC_6_P
CPD_10774	CPD_10774
CPD_10775	CPD_10775
CPD_10776	CPD_10776
_7_AMINOMETHYL_7_DEAZAGUANINE	_7_AMINOMETHYL_7_DEAZAGUANINE
CPD_10773	CPD_10773
PHE	PHE
R_3_hydroxy_cis_vaccenoyl_ACPs	R_3_hydroxy_cis_vaccenoyl_ACPs
Tetradec_2_enoyl_ACPs	Tetradec_2_enoyl_ACPs
Dodec_2_enoyl_ACPs	Dodec_2_enoyl_ACPs
Charged_SER_tRNAs	Charged_SER_tRNAs
_3_oxo_decanoyl_ACPs	_3_oxo_decanoyl_ACPs
CHORISMATE	CHORISMATE
ASN_tRNAs	ASN_tRNAs
R_3_hydroxymyristoyl_ACPs	R_3_hydroxymyristoyl_ACPs
Butanoyl_ACPs	Butanoyl_ACPs
PROTON	PROTON
UDP_N_ACETYL_D_GLUCOSAMINE	UDP_N_ACETYL_D_GLUCOSAMINE
RNASE_II_POLY_A_SUBSTRATE_MRNA	RNASE_II_POLY_A_SUBSTRATE_MRNA
Pi	Pi
P_HYDROXY_PHENYLPYRUVATE	P_HYDROXY_PHENYLPYRUVATE
Charged_GLT_tRNAs	Charged_GLT_tRNAs
GLUCOSAMINE_1P	GLUCOSAMINE_1P
CPD_205	CPD_205
PROTOPORPHYRINOGEN	PROTOPORPHYRINOGEN
Octanoyl_ACPs	Octanoyl_ACPs
CPD_564	CPD_564
O_Sialoglycoproteins	O_Sialoglycoproteins
_3_hydroxy_cis_D7_tetraecenoyl_ACPs	_3_hydroxy_cis_D7_tetraecenoyl_ACPs
DNA_Segment_Placeholder	DNA_Segment_Placeholder
BCCP_biotin_monomers	BCCP_biotin_monomers
L_ASPARTATE	L_ASPARTATE
Persulfurated_L_cysteine_desulfurases	Persulfurated_L_cysteine_desulfurases
CPD_12454	CPD_12454
HIS_tRNAs	HIS_tRNAs
Alpha_D_aldose_1_phosphates	Alpha_D_aldose_1_phosphates
D_SEDOHEPTULOSE_1_7_P2	D_SEDOHEPTULOSE_1_7_P2
BCAA_dehydrogenase_DH_lipoyl	BCAA_dehydrogenase_DH_lipoyl
_2_OXOBUTANOATE	_2_OXOBUTANOATE
Perthiols	Perthiols
PANTOTHENATE	PANTOTHENATE
DGMP	DGMP
MESO_DIAMINOPIMELATE	MESO_DIAMINOPIMELATE
Charged_HIS_tRNAs	Charged_HIS_tRNAs
Charged_GLN_tRNAs	Charged_GLN_tRNAs
DODECANOATE	DODECANOATE
_5_PHOSPHO_RIBOSYL_GLYCINEAMIDE	_5_PHOSPHO_RIBOSYL_GLYCINEAMIDE
L_methionyl_tRNAfmet	L_methionyl_tRNAfmet
RNASE_II_DEGRADATION_SUBSTRATE_MRNA	RNASE_II_DEGRADATION_SUBSTRATE_MRNA
ERYTHRONATE_4P	ERYTHRONATE_4P
_2_C_METHYL_D_ERYTHRITOL_4_PHOSPHATE	_2_C_METHYL_D_ERYTHRITOL_4_PHOSPHATE
PHOSPHORIBOSYL_CARBOXY_AMINOIMIDAZOLE	PHOSPHORIBOSYL_CARBOXY_AMINOIMIDAZOLE
RNASE_III_MRNA_PROCESSING_SUBSTRATE	RNASE_III_MRNA_PROCESSING_SUBSTRATE
NADH	NADH
CPD0_1176	CPD0_1176
UMP	UMP
CPD0_1174	CPD0_1174
ADENINE	ADENINE
NACMUR	NACMUR
_5S_rRNAs	_5S_rRNAs
trans_delta2_lignoceroyl_ACPs	trans_delta2_lignoceroyl_ACPs
Charged_ARG_tRNAs	Charged_ARG_tRNAs
GUANINE	GUANINE
CYTIDINE	CYTIDINE
PHOSPHORIBOSYL_FORMAMIDO_CARBOXAMIDE	PHOSPHORIBOSYL_FORMAMIDO_CARBOXAMIDE
OH_ACYL_ACP	OH_ACYL_ACP
MET_tRNAs	MET_tRNAs
ADP_SUGARS	ADP_SUGARS
ALA_tRNAs	ALA_tRNAs
NADP	NADP
PORPHOBILINOGEN	PORPHOBILINOGEN
Sulfur_Acceptors	Sulfur_Acceptors
FRUCTOSE_16_DIPHOSPHATE	FRUCTOSE_16_DIPHOSPHATE
GLY_tRNAs	GLY_tRNAs
DIHYDROLIPOYL_GCVH	DIHYDROLIPOYL_GCVH
LACTOSE_6P	LACTOSE_6P
RNA_DNA_hybrids	RNA_DNA_hybrids
C6	C6
C5	C5
cleaved_lipoprotein_signal_peptide	cleaved_lipoprotein_signal_peptide
P3I	P3I
Charged_LEU_tRNAs	Charged_LEU_tRNAs
Nucleoside_Triphosphates	Nucleoside_Triphosphates
PYRUVATE	PYRUVATE
NADPH	NADPH
DIHYDROSIROHYDROCHLORIN	DIHYDROSIROHYDROCHLORIN
TRIMETHYLSULFONIUM	TRIMETHYLSULFONIUM
PROTOPORPHYRIN_IX	PROTOPORPHYRIN_IX
RIBULOSE_5P	RIBULOSE_5P
D_6_P_GLUCONO_DELTA_LACTONE	D_6_P_GLUCONO_DELTA_LACTONE
Beta_hydroxydecanoyl_ACPs	Beta_hydroxydecanoyl_ACPs
CDP	CDP
Saturated_2_Lysophosphatidates	Saturated_2_Lysophosphatidates
ERYTHROSE_4P	ERYTHROSE_4P
TDP	TDP
Prolipoproteins	Prolipoproteins
ASP_tRNAs	ASP_tRNAs
_3_oxo_palmitoyl_ACPs	_3_oxo_palmitoyl_ACPs
LACTOSE	LACTOSE
ThiI_L_cysteine	ThiI_L_cysteine
S_LACTOYL_GLUTATHIONE	S_LACTOYL_GLUTATHIONE
FRUCTOSE_6P	FRUCTOSE_6P
SHIKIMATE	SHIKIMATE
DsrC_disulfide_form	DsrC_disulfide_form
DEHYDROQUINATE	DEHYDROQUINATE
DCDP	DCDP
HISTIDINAL	HISTIDINAL
CPD_108	CPD_108
PPI	PPI
_16S_rRNA_cytidine1402	_16S_rRNA_cytidine1402
GAP	GAP
P_AMINO_BENZOATE	P_AMINO_BENZOATE
_3_DEHYDRO_SHIKIMATE	_3_DEHYDRO_SHIKIMATE
CPD_12366	CPD_12366
TusE_L_cysteine	TusE_L_cysteine
Guanine37_in_tRNA	Guanine37_in_tRNA
FAD	FAD
cis_vaccen_2_enoyl_ACPs	cis_vaccen_2_enoyl_ACPs
Sugar	Sugar
PYRIDOXAMINE_5P	PYRIDOXAMINE_5P
RNASE_G_DEGRADATION_SUBSTRATE_MRNA	RNASE_G_DEGRADATION_SUBSTRATE_MRNA
METHYLENE_THF_GLU_N	METHYLENE_THF_GLU_N
UTP	UTP
PREPHENATE	PREPHENATE
SEC_tRNAs	SEC_tRNAs
XYLULOSE_5_PHOSPHATE	XYLULOSE_5_PHOSPHATE
ThiI_S_sulfanylcysteine	ThiI_S_sulfanylcysteine
CPD_552	CPD_552
DGDP	DGDP
CPD_558	CPD_558
DIHYDRONEOPTERIN_P3	DIHYDRONEOPTERIN_P3
_16S_rRNA_N4_methylcytidine1402	_16S_rRNA_N4_methylcytidine1402
CPD0_181	CPD0_181
Palmitoyl_ACPs	Palmitoyl_ACPs
Intracellular_Sulfur	Intracellular_Sulfur
_3_oxo_hexanoyl_ACPs	_3_oxo_hexanoyl_ACPs
ARG	ARG
Ribonucleoside_Triphosphates	Ribonucleoside_Triphosphates
BCCP_monomers	BCCP_monomers
DADP	DADP
_5_10_METHENYL_THF	_5_10_METHENYL_THF
TMP	TMP
CPD_476	CPD_476
_2_O_Methylguanosine18	_2_O_Methylguanosine18
NAD	NAD
PHENYLACETALDEHYDE	PHENYLACETALDEHYDE
DEOXYNUCLEOTIDESM	DEOXYNUCLEOTIDESM
CYS_tRNAs	CYS_tRNAs
VAL_tRNAs	VAL_tRNAs
B_ALANINE	B_ALANINE
_2_Hexadecenoyl_ACPs	_2_Hexadecenoyl_ACPs
ILE	ILE
GLYCEROL	GLYCEROL
Dodecanoyl_ACPs	Dodecanoyl_ACPs
ACETYL_COA	ACETYL_COA
CTP	CTP
UROPORPHYRINOGEN_III	UROPORPHYRINOGEN_III
HYDROXYMETHYLBILANE	HYDROXYMETHYLBILANE
Methylated_methyl_acceptors	Methylated_methyl_acceptors
tRNA_Containing_6Isopentenyladenosine	tRNA_Containing_6Isopentenyladenosine
LYS	LYS
_2_hydroxyacyl_glutathiones	_2_hydroxyacyl_glutathiones
CPD0_1175	CPD0_1175
HCO3	HCO3
CPD_11763	CPD_11763
Enoylpimeloyl_ACP_methyl_esters	Enoylpimeloyl_ACP_methyl_esters
DIHYDROXY_BUTANONE_P	DIHYDROXY_BUTANONE_P
CDPDIACYLGLYCEROL	CDPDIACYLGLYCEROL
Thiols	Thiols
PYRIDOXAL_PHOSPHATE	PYRIDOXAL_PHOSPHATE
DIHYDROFOLATE	DIHYDROFOLATE
POLYPEPTIDE	POLYPEPTIDE
CPD_602	CPD_602
CPD0_1183	CPD0_1183
CPD0_1182	CPD0_1182
CPD0_1181	CPD0_1181
CPD_1301	CPD_1301
O_SUCCINYL_L_HOMOSERINE	O_SUCCINYL_L_HOMOSERINE
_7_CYANO_7_DEAZAGUANINE	_7_CYANO_7_DEAZAGUANINE
_2_KETOGLUTARATE	_2_KETOGLUTARATE
_5_PHOSPHORIBOSYL_N_FORMYLGLYCINEAMIDINE	_5_PHOSPHORIBOSYL_N_FORMYLGLYCINEAMIDINE
R_3_hydroxylignoceroyl_ACPs	R_3_hydroxylignoceroyl_ACPs
Adenylated_ThiS_Proteins	Adenylated_ThiS_Proteins
tRNA_guanosine18	tRNA_guanosine18
OH	OH
CPD_8199	CPD_8199
L_CYSTATHIONINE	L_CYSTATHIONINE
Carboxybiotin_BCCP	Carboxybiotin_BCCP
CPD_7695	CPD_7695
CPD_8200	CPD_8200
L_RHAMNOFURANOSE	L_RHAMNOFURANOSE
MALONYL_ACP	MALONYL_ACP
NICOTINATE_NUCLEOTIDE	NICOTINATE_NUCLEOTIDE
PROPIONYL_P	PROPIONYL_P
Charged_LYS_tRNAs	Charged_LYS_tRNAs
HS	HS
PROTOHEME	PROTOHEME
SHIKIMATE_5P	SHIKIMATE_5P
INOSITOL_1_4_5_TRISPHOSPHATE	INOSITOL_1_4_5_TRISPHOSPHATE
MYO_INOSITOL	MYO_INOSITOL
UDP_N_ACETYLMURAMATE	UDP_N_ACETYLMURAMATE
_3_hydroxy_cis_D9_hexaecenoyl_ACPs	_3_hydroxy_cis_D9_hexaecenoyl_ACPs
LL_DIAMINOPIMELATE	LL_DIAMINOPIMELATE
B_KETOACYL_ACP	B_KETOACYL_ACP
Crotonyl_ACPs	Crotonyl_ACPs
ACYL_SN_GLYCEROL_3P	ACYL_SN_GLYCEROL_3P
_16S_rRNA_N6_dimethyladenine1518_1519	_16S_rRNA_N6_dimethyladenine1518_1519
_2_METHYLTHIO_N_6_ISOPENTYL_ADENOSINE_37_	_2_METHYLTHIO_N_6_ISOPENTYL_ADENOSINE_37_
AMP	AMP
NADH_P_OR_NOP	NADH_P_OR_NOP
signal_peptide	signal_peptide
OROTATE	OROTATE
SE_2	SE_2
CPD_8532	CPD_8532
Protein_N5_methyl_L_glutamine	Protein_N5_methyl_L_glutamine
CPD_8534	CPD_8534
Carboxylic_esters	Carboxylic_esters
TRP	TRP
S_HYDROXYMETHYLGLUTATHIONE	S_HYDROXYMETHYLGLUTATHIONE
Oxidized_ferredoxins	Oxidized_ferredoxins
Enoylglutaryl_ACP_methyl_esters	Enoylglutaryl_ACP_methyl_esters
_5_Phospho_terminated_DNAs	_5_Phospho_terminated_DNAs
XANTHINE	XANTHINE
CYTOSINE	CYTOSINE
_2_Hydroxy_carboxylates	_2_Hydroxy_carboxylates
GLT_tRNAs	GLT_tRNAs
R_3_hydroxystearoyl_ACPs	R_3_hydroxystearoyl_ACPs
_3_hydroxypimeloyl_ACP_methyl_esters	_3_hydroxypimeloyl_ACP_methyl_esters
Trans_D3_cis_D5_dodecenoyl_ACPs	Trans_D3_cis_D5_dodecenoyl_ACPs
Menaquinones	Menaquinones
_3_oxo_dodecanoyl_ACPs	_3_oxo_dodecanoyl_ACPs
PHOSPHO_ENOL_PYRUVATE	PHOSPHO_ENOL_PYRUVATE
_3_Hydroxyglutaryl_ACP_methyl_ester	_3_Hydroxyglutaryl_ACP_methyl_ester
SUC	SUC
DUMP	DUMP
CIS_ACONITATE	CIS_ACONITATE
Ribonucleoside_Diphosphates	Ribonucleoside_Diphosphates
R_3_Hydroxypalmitoyl_ACPs	R_3_Hydroxypalmitoyl_ACPs
tRNA_with_7_aminomethyl_7_deazaguanine	tRNA_with_7_aminomethyl_7_deazaguanine
trans_delta2_arachidoyl_ACPs	trans_delta2_arachidoyl_ACPs
Cis_Delta7_tetradecenoyl_ACPs	Cis_Delta7_tetradecenoyl_ACPs
ACP	ACP
Oxo_glutarate_dehydro_suc_DH_lipoyl	Oxo_glutarate_dehydro_suc_DH_lipoyl
tRNA_Containing_N1_Methylguanine_37	tRNA_Containing_N1_Methylguanine_37
DNA_with_Uracils	DNA_with_Uracils
DI_H_OROTATE	DI_H_OROTATE
DNA_Holder	DNA_Holder
R_3_hydroxycerotoyl_ACPs	R_3_hydroxycerotoyl_ACPs
ACETYL_ACP	ACETYL_ACP
Lipoylated_domains	Lipoylated_domains
LEU_tRNAs	LEU_tRNAs
Supercoiled_Duplex_DNAs	Supercoiled_Duplex_DNAs
LEU	LEU
_4_P_PANTOTHENATE	_4_P_PANTOTHENATE
CPD_9038	CPD_9038
CPD_11281	CPD_11281
THREO_DS_ISO_CITRATE	THREO_DS_ISO_CITRATE
Pyruvate_dehydrogenase_acetylDHlipoyl	Pyruvate_dehydrogenase_acetylDHlipoyl
ADP	ADP
tRNA_pseudouridine55	tRNA_pseudouridine55
_3_oxo_cis_D7_tetradecenoyl_ACPs	_3_oxo_cis_D7_tetradecenoyl_ACPs
Charged_TRP_tRNAs	Charged_TRP_tRNAs
UDP_ACETYL_CARBOXYVINYL_GLUCOSAMINE	UDP_ACETYL_CARBOXYVINYL_GLUCOSAMINE
Shorter_RNAs	Shorter_RNAs
Hex_2_enoyl_ACPs	Hex_2_enoyl_ACPs
tRNA_uridine34	tRNA_uridine34
CARBON_DIOXIDE	CARBON_DIOXIDE
C1	C1
GDP	GDP
L_HISTIDINOL_P	L_HISTIDINOL_P
PYRIDOXINE_5P	PYRIDOXINE_5P
PHE_tRNAs	PHE_tRNAs
L_1_PHOSPHATIDYL_SERINE	L_1_PHOSPHATIDYL_SERINE
COPROPORPHYRINOGEN_III	COPROPORPHYRINOGEN_III
_1_AMINO_PROPAN_2_ONE_3_PHOSPHATE	_1_AMINO_PROPAN_2_ONE_3_PHOSPHATE
N_Substituted_Aminoacyl_tRNA	N_Substituted_Aminoacyl_tRNA
MET	MET
DIAMINONONANOATE	DIAMINONONANOATE
L_SELENOCYSTEINE	L_SELENOCYSTEINE
Charged_GLY_tRNAs	Charged_GLY_tRNAs
Alcohols	Alcohols
KYNURENATE	KYNURENATE
Unsulfurated_Sulfur_Acceptors	Unsulfurated_Sulfur_Acceptors
GLUTATHIONE	GLUTATHIONE
_5_P_RIBOSYL_N_FORMYLGLYCINEAMIDE	_5_P_RIBOSYL_N_FORMYLGLYCINEAMIDE
THIAMINE_PYROPHOSPHATE	THIAMINE_PYROPHOSPHATE
DUTP	DUTP
DNA_N	DNA_N
L_1_PHOSPHATIDYL_GLYCEROL_P	L_1_PHOSPHATIDYL_GLYCEROL_P
CIT	CIT
D_MYO_INOSITOL_1_MONOPHOSPHATE	D_MYO_INOSITOL_1_MONOPHOSPHATE
ARG_tRNAs	ARG_tRNAs
Pimeloyl_ACP_methyl_esters	Pimeloyl_ACP_methyl_esters
FARNESYL_PP	FARNESYL_PP
CPD_1086	CPD_1086
GUANOSINE	GUANOSINE
Donor_H2	Donor_H2
S_ADENOSYLMETHIONINE	S_ADENOSYLMETHIONINE
_6_PYRUVOYL_5678_TETRAHYDROPTERIN	_6_PYRUVOYL_5678_TETRAHYDROPTERIN
_3_ENOLPYRUVYL_SHIKIMATE_5P	_3_ENOLPYRUVYL_SHIKIMATE_5P
Sulfurated_Sulfur_Acceptors	Sulfurated_Sulfur_Acceptors
HEME_O	HEME_O
RNA_Holder	RNA_Holder
_5_phosphooligonucleotides	_5_phosphooligonucleotides
trans_delta2_behenoyl_ACPs	trans_delta2_behenoyl_ACPs
CDP_2_3_4_Saturated_Diacylglycerols	CDP_2_3_4_Saturated_Diacylglycerols
DEOXYXYLULOSE_5P	DEOXYXYLULOSE_5P
FORMYL_THF_GLU_N	FORMYL_THF_GLU_N
CARBAMYUL_L_ASPARTATE	CARBAMYUL_L_ASPARTATE
Amino_Acids_20	Amino_Acids_20
GLN_tRNAs	GLN_tRNAs
_5_FORMYL_THF	_5_FORMYL_THF
OXALO_SUCCINATE	OXALO_SUCCINATE
Dihydro_Lipoyl_Proteins	Dihydro_Lipoyl_Proteins
CHOLINE	CHOLINE
DCTP	DCTP
Quinones	Quinones
SER_tRNAs	SER_tRNAs
DIHYDROXYPENTANEDIONE	DIHYDROXYPENTANEDIONE
_2_Octenoyl_ACPs	_2_Octenoyl_ACPs
CPD_9245	CPD_9245
CPD_316	CPD_316
CPD0_1082	CPD0_1082
CPD_12377	CPD_12377
CPD0_1080	CPD0_1080
CPD0_1081	CPD0_1081
AMINO_HYDROXYMETHYL_METHYLPYRIMIDINE_PP	AMINO_HYDROXYMETHYL_METHYLPYRIMIDINE_PP
CPD_12279	CPD_12279
Fatty_Acyl_CoA	Fatty_Acyl_CoA
PHOSPHORIBULOSYL_FORMIMINO_AICAR_P	PHOSPHORIBULOSYL_FORMIMINO_AICAR_P
tRNAs_with_CCA	tRNAs_with_CCA
Lipoyl_ACPs	Lipoyl_ACPs
