#hypernode nodes
_2_ACETO_LACTATE	_2_ACETO_LACTATE
SUC_COA	SUC_COA
AMMONIUM	AMMONIUM
Charged_ASP_tRNAs	Charged_ASP_tRNAs
ACET	ACET
FORMYL_L_METHIONYL_PEPTIDE	FORMYL_L_METHIONYL_PEPTIDE
_3_Oxo_octanoyl_ACPs	_3_Oxo_octanoyl_ACPs
Octanoylated_domains	Octanoylated_domains
VAL	VAL
ADENOSYL_HOMO_CYS	ADENOSYL_HOMO_CYS
CPD_2961	CPD_2961
FORMALDEHYDE	FORMALDEHYDE
Ribonucleoside_Diphosphates	Ribonucleoside_Diphosphates
_2_ACETO_2_HYDROXY_BUTYRATE	_2_ACETO_2_HYDROXY_BUTYRATE
WATER	WATER
tRNAs	tRNAs
_2_D_THREO_HYDROXY_3_CARBOXY_ISOCAPROATE	_2_D_THREO_HYDROXY_3_CARBOXY_ISOCAPROATE
PRPP	PRPP
_5_Phosphomononucleotides	_5_Phosphomononucleotides
R_3_hydroxydodecanoyl_ACPs	R_3_hydroxydodecanoyl_ACPs
MAL	MAL
DELTA1_PIPERIDEINE_2_6_DICARBOXYLATE	DELTA1_PIPERIDEINE_2_6_DICARBOXYLATE
D_SEDOHEPTULOSE_7_P	D_SEDOHEPTULOSE_7_P
D_ERYTHRO_IMIDAZOLE_GLYCEROL_P	D_ERYTHRO_IMIDAZOLE_GLYCEROL_P
THYMIDINE	THYMIDINE
Myristoyl_ACPs	Myristoyl_ACPs
Reduced_ferredoxins	Reduced_ferredoxins
Decanoyl_ACPs	Decanoyl_ACPs
Charged_THR_tRNAs	Charged_THR_tRNAs
CPD_7046	CPD_7046
Ox_Thioredoxin	Ox_Thioredoxin
CMP	CMP
_1_KETO_2_METHYLVALERATE	_1_KETO_2_METHYLVALERATE
N_Substituted_Amino_Acids	N_Substituted_Amino_Acids
tRNA_Holder	tRNA_Holder
Octadec_2_enoyl_ACPs	Octadec_2_enoyl_ACPs
CPD_9245	CPD_9245
CPD0_1108	CPD0_1108
R_3_hydroxy_cis_vaccenoyl_ACPs	R_3_hydroxy_cis_vaccenoyl_ACPs
b_Hydroxy_cis_D5_dodecenoyl_ACPs	b_Hydroxy_cis_D5_dodecenoyl_ACPs
DIHYDROXY_ACETONE_PHOSPHATE	DIHYDROXY_ACETONE_PHOSPHATE
AICAR	AICAR
OROTIDINE_5_PHOSPHATE	OROTIDINE_5_PHOSPHATE
FRUCTOSE_16_DIPHOSPHATE	FRUCTOSE_16_DIPHOSPHATE
_3OH_4P_OH_ALPHA_KETOBUTYRATE	_3OH_4P_OH_ALPHA_KETOBUTYRATE
O_UREIDOHOMOSERINE	O_UREIDOHOMOSERINE
D_ALANINE	D_ALANINE
Saturated_Fatty_Acyl_ACPs	Saturated_Fatty_Acyl_ACPs
PROTEIN_LIPOYLLYSINE	PROTEIN_LIPOYLLYSINE
_16S_rRNA_2_O_methylcytidine1402	_16S_rRNA_2_O_methylcytidine1402
THYMINE	THYMINE
_4_PHOSPHONOOXY_THREONINE	_4_PHOSPHONOOXY_THREONINE
_3_oxo_stearoyl_ACPs	_3_oxo_stearoyl_ACPs
cis_vaccen_2_enoyl_ACPs	cis_vaccen_2_enoyl_ACPs
N_ACETYL_GLUTAMYL_P	N_ACETYL_GLUTAMYL_P
_2R_HYDROPEROXY_FATTY_ACIDS	_2R_HYDROPEROXY_FATTY_ACIDS
Deoxynucleotides	Deoxynucleotides
_5_METHYL_THF	_5_METHYL_THF
GLN	GLN
Reduced_flavodoxins	Reduced_flavodoxins
Dodec_2_enoyl_ACPs	Dodec_2_enoyl_ACPs
GLY	GLY
GLT	GLT
HISTIDINOL	HISTIDINOL
Charged_ILE_tRNAs	Charged_ILE_tRNAs
_3_P_SERINE	_3_P_SERINE
_3_DEOXY_D_ARABINO_HEPTULOSONATE_7_P	_3_DEOXY_D_ARABINO_HEPTULOSONATE_7_P
RNASE_III_PROCESSING_PRODUCT_MRNA	RNASE_III_PROCESSING_PRODUCT_MRNA
Charged_GLY_tRNAs	Charged_GLY_tRNAs
CPD0_2472	CPD0_2472
Charged_PRO_tRNAs	Charged_PRO_tRNAs
CPD0_2354	CPD0_2354
TusE_S_sulfanylcysteine	TusE_S_sulfanylcysteine
CPD0_2353	CPD0_2353
RIBOSE	RIBOSE
NICOTINAMIDE_NUCLEOTIDE	NICOTINAMIDE_NUCLEOTIDE
URIDINE	URIDINE
CPD0_2350	CPD0_2350
R_3_hydroxyhexanoyl_ACPs	R_3_hydroxyhexanoyl_ACPs
URACIL	URACIL
MESO_DIAMINOPIMELATE	MESO_DIAMINOPIMELATE
Single_Stranded_DNAs	Single_Stranded_DNAs
HYDROGEN_PEROXIDE	HYDROGEN_PEROXIDE
CPD_536	CPD_536
Oxidized_flavodoxins	Oxidized_flavodoxins
DNA_Combined_With_Exogenous_DNA	DNA_Combined_With_Exogenous_DNA
CPD_653	CPD_653
_2K_4CH3_PENTANOATE	_2K_4CH3_PENTANOATE
CPD0_2352	CPD0_2352
CPD0_2351	CPD0_2351
RIBOSE_1P	RIBOSE_1P
DPG	DPG
PROPIONATE	PROPIONATE
GLT_tRNAs	GLT_tRNAs
HIS	HIS
_23S_rRNA_pseudouridine1911_1915_1917	_23S_rRNA_pseudouridine1911_1915_1917
_23S_rRNA_pseudouridine2605	_23S_rRNA_pseudouridine2605
_2_PG	_2_PG
AP_Site_Created	AP_Site_Created
PRO_tRNAs	PRO_tRNAs
All_tRNAs	All_tRNAs
O_PHOSPHO_L_HOMOSERINE	O_PHOSPHO_L_HOMOSERINE
Nucleoside_Diphosphates	Nucleoside_Diphosphates
L_CITRULLINE	L_CITRULLINE
Oligonucleotides	Oligonucleotides
apo_ACP	apo_ACP
Charged_ALA_tRNAs	Charged_ALA_tRNAs
CPD_1302	CPD_1302
Resolution_of_Recombinational_Junction	Resolution_of_Recombinational_Junction
CPD_1301	CPD_1301
UDP	UDP
Red_Thioredoxin	Red_Thioredoxin
R_3_hydroxyarachidoyl_ACPs	R_3_hydroxyarachidoyl_ACPs
Non_lipoylated_domains	Non_lipoylated_domains
PHOSPHORIBOSYL_FORMIMINO_AICAR_P	PHOSPHORIBOSYL_FORMIMINO_AICAR_P
Pyruvate_dehydrogenase_dihydrolipoate	Pyruvate_dehydrogenase_dihydrolipoate
BCAA_dehydrogenase_lipoyl	BCAA_dehydrogenase_lipoyl
ACETYL_GLU	ACETYL_GLU
Charged_VAL_tRNAs	Charged_VAL_tRNAs
THR_tRNAs	THR_tRNAs
ADENOSINE	ADENOSINE
SHIKIMATE	SHIKIMATE
ssRNAs	ssRNAs
CPD_7100	CPD_7100
_23S_rRNA_2_O_methyluridine2552	_23S_rRNA_2_O_methyluridine2552
Hexanoyl_ACPs	Hexanoyl_ACPs
OXYGEN_MOLECULE	OXYGEN_MOLECULE
DEOXY_RIBOSE_1P	DEOXY_RIBOSE_1P
Apo_GcvH	Apo_GcvH
Peptides_with_Leader_Sequence	Peptides_with_Leader_Sequence
METHYLENE_THF	METHYLENE_THF
_3_CARBOXY_3_HYDROXY_ISOCAPROATE	_3_CARBOXY_3_HYDROXY_ISOCAPROATE
N_formyl_L_methionyl_tRNAfmet	N_formyl_L_methionyl_tRNAfmet
Trans_D2_hexacos_2_enoyl_ACPs	Trans_D2_hexacos_2_enoyl_ACPs
tRNA_uridine_38_40	tRNA_uridine_38_40
ACETALD	ACETALD
Trans_D3_cis_D9_hexadecenoyl_ACPs	Trans_D3_cis_D9_hexadecenoyl_ACPs
TYR	TYR
mRNAs	mRNAs
_3_oxo_cis_vaccenoyl_ACPs	_3_oxo_cis_vaccenoyl_ACPs
ATP	ATP
Beta_3_hydroxybutyryl_ACPs	Beta_3_hydroxybutyryl_ACPs
Unsulfurated_Sulfur_Acceptors	Unsulfurated_Sulfur_Acceptors
ETOH	ETOH
_3_oxo_myristoyl_ACPs	_3_oxo_myristoyl_ACPs
tRNA_Arg_adenosine34	tRNA_Arg_adenosine34
FUM	FUM
TRANS_D2_ENOYL_ACP	TRANS_D2_ENOYL_ACP
DIHYDROLIPOAMIDE	DIHYDROLIPOAMIDE
IMIDAZOLE_ACETOL_P	IMIDAZOLE_ACETOL_P
N_6_ISOPENTYL_ADENOSINE_37_TRNA	N_6_ISOPENTYL_ADENOSINE_37_TRNA
CARBAMOYL_P	CARBAMOYL_P
Pimeloyl_ACPs	Pimeloyl_ACPs
_16S_rRNA_adenine1518_adenine1519	_16S_rRNA_adenine1518_adenine1519
RIBOSE_5P	RIBOSE_5P
PHOSPHORIBOSYL_AMP	PHOSPHORIBOSYL_AMP
Double_Stranded_DNAs	Double_Stranded_DNAs
General_Protein_Substrates	General_Protein_Substrates
TRP_tRNAs	TRP_tRNAs
PANTETHEINE_P	PANTETHEINE_P
DNA_with_Uracils	DNA_with_Uracils
E_	E_
CPD_7670	CPD_7670
_23S_rRNA_uridine1911_1915_1917	_23S_rRNA_uridine1911_1915_1917
PHOSPHORIBOSYL_ATP	PHOSPHORIBOSYL_ATP
Charged_MET_tRNAs	Charged_MET_tRNAs
Lipoyl_Protein	Lipoyl_Protein
GLYCERALD	GLYCERALD
Acetoacetyl_ACPs	Acetoacetyl_ACPs
AMMONIA	AMMONIA
FRU1P	FRU1P
LIPOAMIDE	LIPOAMIDE
tRNA_pseudouridine_38_40	tRNA_pseudouridine_38_40
Charged_CYS_tRNAs	Charged_CYS_tRNAs
L_ARGININO_SUCCINATE	L_ARGININO_SUCCINATE
AMINOMETHYLDIHYDROLIPOYL_GCVH	AMINOMETHYLDIHYDROLIPOYL_GCVH
Protein_With_N_Terminal_Met	Protein_With_N_Terminal_Met
HOMO_CYS	HOMO_CYS
SER	SER
Palmitoleoyl_ACPs	Palmitoleoyl_ACPs
R_3_hydroxybehenoyl_ACPs	R_3_hydroxybehenoyl_ACPs
GUANINE	GUANINE
GLC_6_P	GLC_6_P
Cis_delta_3_decenoyl_ACPs	Cis_delta_3_decenoyl_ACPs
Glutaryl_ACP_methyl_esters	Glutaryl_ACP_methyl_esters
L_Cysteine_Desulfurases	L_Cysteine_Desulfurases
ASN	ASN
_23S_rRNA_uridine_2552	_23S_rRNA_uridine_2552
Relaxed_DNAs	Relaxed_DNAs
D_6_P_GLUCONO_DELTA_LACTONE	D_6_P_GLUCONO_DELTA_LACTONE
NAD_P_OR_NOP	NAD_P_OR_NOP
Charged_PHE_tRNAs	Charged_PHE_tRNAs
MALONYL_COA	MALONYL_COA
HOMO_SER	HOMO_SER
Octanoyl_ACPs	Octanoyl_ACPs
_3_Ketopimeloyl_ACP_methyl_esters	_3_Ketopimeloyl_ACP_methyl_esters
Nucleoside_Monophosphates	Nucleoside_Monophosphates
_2_KETO_ISOVALERATE	_2_KETO_ISOVALERATE
L_ORNITHINE	L_ORNITHINE
RNASE_II_POLY_A_SUBSTRATE_MRNA	RNASE_II_POLY_A_SUBSTRATE_MRNA
CPD_4211	CPD_4211
CYS	CYS
Carboxylates	Carboxylates
_3_Hydroxy_octanoyl_ACPs	_3_Hydroxy_octanoyl_ACPs
Enoylpimeloyl_ACP_methyl_esters	Enoylpimeloyl_ACP_methyl_esters
_3_oxo_cis_D9_hexadecenoyl_ACPs	_3_oxo_cis_D9_hexadecenoyl_ACPs
CH33ADO	CH33ADO
Negatively_super_coiled_DNAs	Negatively_super_coiled_DNAs
Charged_TRP_tRNAs	Charged_TRP_tRNAs
LYS_tRNAs	LYS_tRNAs
tRNA_Dihydrouridines	tRNA_Dihydrouridines
Leader_Sequences	Leader_Sequences
Cis_Delta5_dodecenoyl_ACPs	Cis_Delta5_dodecenoyl_ACPs
RNASE_II_SUBSTRATE_WITH_NO_POLY_A_TAIL	RNASE_II_SUBSTRATE_WITH_NO_POLY_A_TAIL
_23S_rRNA_uridine955_2504_2580	_23S_rRNA_uridine955_2504_2580
_2_ALPHA_HYDROXYETHYL_THPP	_2_ALPHA_HYDROXYETHYL_THPP
tRNA_uridine55	tRNA_uridine55
_3_Ketoglutaryl_ACP_methyl_ester	_3_Ketoglutaryl_ACP_methyl_ester
Ribonucleoside_Monophosphates	Ribonucleoside_Monophosphates
_16S_rRNA_N4_methylcytidine1402	_16S_rRNA_N4_methylcytidine1402
_16S_rRNA_guanine_966	_16S_rRNA_guanine_966
L_seryl_SEC_tRNAs	L_seryl_SEC_tRNAs
Deoxy_Ribonucleoside_Triphosphates	Deoxy_Ribonucleoside_Triphosphates
_23S_rRNA_pseudouridine955_2504_2580	_23S_rRNA_pseudouridine955_2504_2580
_5_phosphooligonucleotides	_5_phosphooligonucleotides
_3_5_ADP	_3_5_ADP
ILE_tRNAs	ILE_tRNAs
CO_A	CO_A
GMP	GMP
Trans_D2_decenoyl_ACPs	Trans_D2_decenoyl_ACPs
HYDROGEN_MOLECULE	HYDROGEN_MOLECULE
Oxo_glutarate_dehydrogenase_lipoyl	Oxo_glutarate_dehydrogenase_lipoyl
ACETYL_P	ACETYL_P
b_Keto_cis_D5_dodecenoyl_ACPs	b_Keto_cis_D5_dodecenoyl_ACPs
TYR_tRNAs	TYR_tRNAs
L_ALPHA_ALANINE	L_ALPHA_ALANINE
METHIONYL_PEPTIDE	METHIONYL_PEPTIDE
METOH	METOH
Trans_D3_cis_D7_tetradecenoyl_ACPs	Trans_D3_cis_D7_tetradecenoyl_ACPs
D_LACTATE	D_LACTATE
THR	THR
Peptides	Peptides
Charged_ASN_tRNAs	Charged_ASN_tRNAs
THF	THF
Short_RNA_Fragments	Short_RNA_Fragments
N_SUCCINYL_2_AMINO_6_KETOPIMELATE	N_SUCCINYL_2_AMINO_6_KETOPIMELATE
ALPHA_GLC_6_P	ALPHA_GLC_6_P
PHE	PHE
Alkyl_Hydro_Peroxides	Alkyl_Hydro_Peroxides
CHORISMATE	CHORISMATE
ASN_tRNAs	ASN_tRNAs
R_3_hydroxymyristoyl_ACPs	R_3_hydroxymyristoyl_ACPs
tRNA_precursors	tRNA_precursors
PROTON	PROTON
Pyruvate_dehydrogenase_lipoate	Pyruvate_dehydrogenase_lipoate
tRNA_2_thiouridine34	tRNA_2_thiouridine34
Pi	Pi
Charged_GLT_tRNAs	Charged_GLT_tRNAs
_3_hydroxy_cis_D7_tetraecenoyl_ACPs	_3_hydroxy_cis_D7_tetraecenoyl_ACPs
_16S_rRNA_guanine_1207	_16S_rRNA_guanine_1207
CIT	CIT
L_ASPARTATE	L_ASPARTATE
Persulfurated_L_cysteine_desulfurases	Persulfurated_L_cysteine_desulfurases
Charged_SER_tRNAs	Charged_SER_tRNAs
HIS_tRNAs	HIS_tRNAs
D_SEDOHEPTULOSE_1_7_P2	D_SEDOHEPTULOSE_1_7_P2
BCAA_dehydrogenase_DH_lipoyl	BCAA_dehydrogenase_DH_lipoyl
_2_OXOBUTANOATE	_2_OXOBUTANOATE
L_ALPHA_AMINO_EPSILON_KETO_PIMELATE	L_ALPHA_AMINO_EPSILON_KETO_PIMELATE
Charged_HIS_tRNAs	Charged_HIS_tRNAs
Charged_GLN_tRNAs	Charged_GLN_tRNAs
DODECANOATE	DODECANOATE
L_methionyl_tRNAfmet	L_methionyl_tRNAfmet
RNASE_II_DEGRADATION_SUBSTRATE_MRNA	RNASE_II_DEGRADATION_SUBSTRATE_MRNA
ERYTHRONATE_4P	ERYTHRONATE_4P
PRO	PRO
TMP	TMP
RNASE_III_MRNA_PROCESSING_SUBSTRATE	RNASE_III_MRNA_PROCESSING_SUBSTRATE
ILE	ILE
UMP	UMP
ADENINE	ADENINE
trans_delta2_lignoceroyl_ACPs	trans_delta2_lignoceroyl_ACPs
Charged_ARG_tRNAs	Charged_ARG_tRNAs
_2_AMINO_3_OXO_4_PHOSPHONOOXYBUTYRATE	_2_AMINO_3_OXO_4_PHOSPHONOOXYBUTYRATE
CYTIDINE	CYTIDINE
_3_P_HYDROXYPYRUVATE	_3_P_HYDROXYPYRUVATE
MET_tRNAs	MET_tRNAs
ALA_tRNAs	ALA_tRNAs
NADP	NADP
Sulfur_Acceptors	Sulfur_Acceptors
Charged_TYR_tRNAs	Charged_TYR_tRNAs
GLY_tRNAs	GLY_tRNAs
DIHYDROLIPOYL_GCVH	DIHYDROLIPOYL_GCVH
_2_3_DIHYDRODIPICOLINATE	_2_3_DIHYDRODIPICOLINATE
Butanoyl_ACPs	Butanoyl_ACPs
cleaved_lipoprotein_signal_peptide	cleaved_lipoprotein_signal_peptide
Charged_LEU_tRNAs	Charged_LEU_tRNAs
Nucleoside_Triphosphates	Nucleoside_Triphosphates
PYRUVATE	PYRUVATE
NADPH	NADPH
TRIMETHYLSULFONIUM	TRIMETHYLSULFONIUM
RIBULOSE_5P	RIBULOSE_5P
_10_FORMYL_THF	_10_FORMYL_THF
Beta_hydroxydecanoyl_ACPs	Beta_hydroxydecanoyl_ACPs
CDP	CDP
ERYTHROSE_4P	ERYTHROSE_4P
TDP	TDP
ASP_tRNAs	ASP_tRNAs
_23S_rRNA_adenine_2503	_23S_rRNA_adenine_2503
_3_oxo_palmitoyl_ACPs	_3_oxo_palmitoyl_ACPs
ThiI_L_cysteine	ThiI_L_cysteine
FRUCTOSE_6P	FRUCTOSE_6P
OXALACETIC_ACID	OXALACETIC_ACID
DEHYDROQUINATE	DEHYDROQUINATE
HISTIDINAL	HISTIDINAL
G3P	G3P
PPI	PPI
_16S_rRNA_cytidine1402	_16S_rRNA_cytidine1402
GAP	GAP
_3_DEHYDRO_SHIKIMATE	_3_DEHYDRO_SHIKIMATE
TusE_L_cysteine	TusE_L_cysteine
Guanine37_in_tRNA	Guanine37_in_tRNA
ACYL_COA	ACYL_COA
PYRIDOXAMINE_5P	PYRIDOXAMINE_5P
CPD0_2189	CPD0_2189
Fatty_Aldehydes	Fatty_Aldehydes
PREPHENATE	PREPHENATE
SEC_tRNAs	SEC_tRNAs
XYLULOSE_5_PHOSPHATE	XYLULOSE_5_PHOSPHATE
ThiI_S_sulfanylcysteine	ThiI_S_sulfanylcysteine
PALMITATE	PALMITATE
Palmitoyl_ACPs	Palmitoyl_ACPs
_3_oxo_hexanoyl_ACPs	_3_oxo_hexanoyl_ACPs
ARG	ARG
Oxo_glutarate_dehydrogenase_DH_lipoyl	Oxo_glutarate_dehydrogenase_DH_lipoyl
_5_10_METHENYL_THF	_5_10_METHENYL_THF
FORMATE	FORMATE
NAD	NAD
DEOXYNUCLEOTIDESM	DEOXYNUCLEOTIDESM
CYS_tRNAs	CYS_tRNAs
VAL_tRNAs	VAL_tRNAs
_2_Hexadecenoyl_ACPs	_2_Hexadecenoyl_ACPs
NADH	NADH
GLYCEROL	GLYCEROL
Dodecanoyl_ACPs	Dodecanoyl_ACPs
ACETYL_COA	ACETYL_COA
CTP	CTP
DNA_With_G_A_Mismatch	DNA_With_G_A_Mismatch
tRNA_Containing_6Isopentenyladenosine	tRNA_Containing_6Isopentenyladenosine
LYS	LYS
HCO3	HCO3
L_CANALINE	L_CANALINE
_16S_rRNA_N2_methylguanine1207	_16S_rRNA_N2_methylguanine1207
PHENYL_PYRUVATE	PHENYL_PYRUVATE
PYRIDOXAL_PHOSPHATE	PYRIDOXAL_PHOSPHATE
DIHYDROFOLATE	DIHYDROFOLATE
DIOH_ISOVALERATE	DIOH_ISOVALERATE
L_BETA_ASPARTYL_P	L_BETA_ASPARTYL_P
_23S_rRNA_2_methyladenine2503	_23S_rRNA_2_methyladenine2503
_2_KETOGLUTARATE	_2_KETOGLUTARATE
R_3_hydroxylignoceroyl_ACPs	R_3_hydroxylignoceroyl_ACPs
OH_ACYL_ACP	OH_ACYL_ACP
OH	OH
_2_METHYLTHIO_N_6_ISOPENTYL_ADENOSINE_37_	_2_METHYLTHIO_N_6_ISOPENTYL_ADENOSINE_37_
tRNA_Arg_inosine34	tRNA_Arg_inosine34
MALONYL_ACP	MALONYL_ACP
PROPIONYL_P	PROPIONYL_P
Charged_LYS_tRNAs	Charged_LYS_tRNAs
tRNA_pseudouridine55	tRNA_pseudouridine55
SHIKIMATE_5P	SHIKIMATE_5P
MYO_INOSITOL	MYO_INOSITOL
Dihydro_Lipoyl_Proteins	Dihydro_Lipoyl_Proteins
_3_hydroxy_cis_D9_hexaecenoyl_ACPs	_3_hydroxy_cis_D9_hexaecenoyl_ACPs
LL_DIAMINOPIMELATE	LL_DIAMINOPIMELATE
B_KETOACYL_ACP	B_KETOACYL_ACP
Crotonyl_ACPs	Crotonyl_ACPs
CARBAMYUL_L_ASPARTATE	CARBAMYUL_L_ASPARTATE
AMP	AMP
NADH_P_OR_NOP	NADH_P_OR_NOP
OROTATE	OROTATE
N_SUCCINYLLL_2_6_DIAMINOPIMELATE	N_SUCCINYLLL_2_6_DIAMINOPIMELATE
CPD_8532	CPD_8532
CPD_469	CPD_469
Carboxylic_esters	Carboxylic_esters
TRP	TRP
Oxidized_ferredoxins	Oxidized_ferredoxins
_16S_rRNA_N2_methylguanine966	_16S_rRNA_N2_methylguanine966
Enoylglutaryl_ACP_methyl_esters	Enoylglutaryl_ACP_methyl_esters
CPD_9451	CPD_9451
DNA_With_Mismatched_Adenine	DNA_With_Mismatched_Adenine
RIBONUCLEOSIDE_TRIP_REDUCT_MONOMER	RIBONUCLEOSIDE_TRIP_REDUCT_MONOMER
R_3_hydroxystearoyl_ACPs	R_3_hydroxystearoyl_ACPs
_3_hydroxypimeloyl_ACP_methyl_esters	_3_hydroxypimeloyl_ACP_methyl_esters
Trans_D3_cis_D5_dodecenoyl_ACPs	Trans_D3_cis_D5_dodecenoyl_ACPs
_3_oxo_dodecanoyl_ACPs	_3_oxo_dodecanoyl_ACPs
PHOSPHO_ENOL_PYRUVATE	PHOSPHO_ENOL_PYRUVATE
_3_Hydroxyglutaryl_ACP_methyl_ester	_3_Hydroxyglutaryl_ACP_methyl_ester
SUC	SUC
DUMP	DUMP
CIS_ACONITATE	CIS_ACONITATE
R_3_Hydroxypalmitoyl_ACPs	R_3_Hydroxypalmitoyl_ACPs
trans_delta2_arachidoyl_ACPs	trans_delta2_arachidoyl_ACPs
Cis_Delta7_tetradecenoyl_ACPs	Cis_Delta7_tetradecenoyl_ACPs
ACP	ACP
Oxo_glutarate_dehydro_suc_DH_lipoyl	Oxo_glutarate_dehydro_suc_DH_lipoyl
tRNA_Containing_N1_Methylguanine_37	tRNA_Containing_N1_Methylguanine_37
_23S_rRNA_uridine2605	_23S_rRNA_uridine2605
DI_H_OROTATE	DI_H_OROTATE
R_3_hydroxycerotoyl_ACPs	R_3_hydroxycerotoyl_ACPs
ACETYL_ACP	ACETYL_ACP
Lipoylated_domains	Lipoylated_domains
LEU_tRNAs	LEU_tRNAs
Supercoiled_Duplex_DNAs	Supercoiled_Duplex_DNAs
THREO_DS_ISO_CITRATE	THREO_DS_ISO_CITRATE
Pyruvate_dehydrogenase_acetylDHlipoyl	Pyruvate_dehydrogenase_acetylDHlipoyl
ADP	ADP
PROTOHEME	PROTOHEME
_3_oxo_cis_D7_tetradecenoyl_ACPs	_3_oxo_cis_D7_tetradecenoyl_ACPs
GUANOSINE	GUANOSINE
Shorter_RNAs	Shorter_RNAs
Hex_2_enoyl_ACPs	Hex_2_enoyl_ACPs
tRNA_uridine34	tRNA_uridine34
CARBON_DIOXIDE	CARBON_DIOXIDE
GDP	GDP
L_HISTIDINOL_P	L_HISTIDINOL_P
PYRIDOXINE_5P	PYRIDOXINE_5P
PHE_tRNAs	PHE_tRNAs
_1_AMINO_PROPAN_2_ONE_3_PHOSPHATE	_1_AMINO_PROPAN_2_ONE_3_PHOSPHATE
N_Substituted_Aminoacyl_tRNA	N_Substituted_Aminoacyl_tRNA
MET	MET
LEU	LEU
Alcohols	Alcohols
THIAMINE_PYROPHOSPHATE	THIAMINE_PYROPHOSPHATE
DUTP	DUTP
L_ASPARTATE_SEMIALDEHYDE	L_ASPARTATE_SEMIALDEHYDE
DNA_N	DNA_N
_3_oxo_decanoyl_ACPs	_3_oxo_decanoyl_ACPs
D_MYO_INOSITOL_1_MONOPHOSPHATE	D_MYO_INOSITOL_1_MONOPHOSPHATE
ARG_tRNAs	ARG_tRNAs
Pimeloyl_ACP_methyl_esters	Pimeloyl_ACP_methyl_esters
MONOMER0_2863	MONOMER0_2863
FARNESYL_PP	FARNESYL_PP
S_ADENOSYLMETHIONINE	S_ADENOSYLMETHIONINE
_3_ENOLPYRUVYL_SHIKIMATE_5P	_3_ENOLPYRUVYL_SHIKIMATE_5P
Sulfurated_Sulfur_Acceptors	Sulfurated_Sulfur_Acceptors
HEME_O	HEME_O
RNA_Holder	RNA_Holder
trans_delta2_behenoyl_ACPs	trans_delta2_behenoyl_ACPs
DEOXYXYLULOSE_5P	DEOXYXYLULOSE_5P
_16S_rRNA_N6_dimethyladenine1518_1519	_16S_rRNA_N6_dimethyladenine1518_1519
GLN_tRNAs	GLN_tRNAs
SER_tRNAs	SER_tRNAs
N_ALPHA_ACETYLORNITHINE	N_ALPHA_ACETYLORNITHINE
_2_Octenoyl_ACPs	_2_Octenoyl_ACPs
Tetradec_2_enoyl_ACPs	Tetradec_2_enoyl_ACPs
_5_FORMYL_THF	_5_FORMYL_THF
PHOSPHORIBULOSYL_FORMIMINO_AICAR_P	PHOSPHORIBULOSYL_FORMIMINO_AICAR_P
tRNAs_with_CCA	tRNAs_with_CCA
Lipoyl_ACPs	Lipoyl_ACPs
_2_KETO_3_METHYL_VALERATE	_2_KETO_3_METHYL_VALERATE
