#hypernode nodes
CIS_ACONITATE	CIS_ACONITATE
FORMATE	FORMATE
tRNA_Ile2	tRNA_Ile2
Deoxy_Ribonucleoside_Triphosphates	Deoxy_Ribonucleoside_Triphosphates
NAD	NAD
BCAA_dehydrogenase_lipoyl	BCAA_dehydrogenase_lipoyl
GLY_tRNAs	GLY_tRNAs
SE_2	SE_2
ACETYL_GLU	ACETYL_GLU
SUC_COA	SUC_COA
AMMONIUM	AMMONIUM
CPD0_2352	CPD0_2352
_3_SULFINOALANINE	_3_SULFINOALANINE
ILE	ILE
Charged_VAL_tRNAs	Charged_VAL_tRNAs
CPD_12115	CPD_12115
THR_tRNAs	THR_tRNAs
tRNA_precursors	tRNA_precursors
ACETYL_COA	ACETYL_COA
CTP	CTP
SHIKIMATE	SHIKIMATE
GAP	GAP
Charged_ASP_tRNAs	Charged_ASP_tRNAs
ACET	ACET
ILE_tRNAs	ILE_tRNAs
CYS_tRNAs	CYS_tRNAs
CO_A	CO_A
REDUCED_MENAQUINONE	REDUCED_MENAQUINONE
LYS	LYS
ssRNAs	ssRNAs
tRNA_guanosine18	tRNA_guanosine18
CPD_7100	CPD_7100
tRNA_pseudouridine_38_40	tRNA_pseudouridine_38_40
Oxo_glutarate_dehydrogenase_lipoyl	Oxo_glutarate_dehydrogenase_lipoyl
FORMYL_L_METHIONYL_PEPTIDE	FORMYL_L_METHIONYL_PEPTIDE
tRNA_containing_5_CarbMeAminome_2_ThioU	tRNA_containing_5_CarbMeAminome_2_ThioU
ACETYL_P	ACETYL_P
CPD_380	CPD_380
_16S_rRNA_N6_dimethyladenine1518_1519	_16S_rRNA_N6_dimethyladenine1518_1519
OCTAPRENYL_DIPHOSPHATE	OCTAPRENYL_DIPHOSPHATE
ANTHRANILATE	ANTHRANILATE
_3_SULFINYL_PYRUVATE	_3_SULFINYL_PYRUVATE
FUM	FUM
HSO3	HSO3
CPD_7224	CPD_7224
OXYGEN_MOLECULE	OXYGEN_MOLECULE
CPD_653	CPD_653
Octanoylated_domains	Octanoylated_domains
METHIONYL_PEPTIDE	METHIONYL_PEPTIDE
OCTAPRENYL_METHOXY_BENZOQUINONE	OCTAPRENYL_METHOXY_BENZOQUINONE
DIOH_ISOVALERATE	DIOH_ISOVALERATE
L_BETA_ASPARTYL_P	L_BETA_ASPARTYL_P
CPD_448	CPD_448
ADENOSYL_HOMO_CYS	ADENOSYL_HOMO_CYS
D_LACTATE	D_LACTATE
THR	THR
VAL_tRNAs	VAL_tRNAs
Oxidized_NrdH_Proteins	Oxidized_NrdH_Proteins
Red_Thioredoxin	Red_Thioredoxin
CPD_367	CPD_367
DIHYDROXYNAPHTHOATE	DIHYDROXYNAPHTHOATE
_3_CARBOXY_3_HYDROXY_ISOCAPROATE	_3_CARBOXY_3_HYDROXY_ISOCAPROATE
Ubiquinones	Ubiquinones
ALA_tRNAs	ALA_tRNAs
Ribonucleoside_Diphosphates	Ribonucleoside_Diphosphates
N_SUCCINYL_2_AMINO_6_KETOPIMELATE	N_SUCCINYL_2_AMINO_6_KETOPIMELATE
ALPHA_GLC_6_P	ALPHA_GLC_6_P
PRO	PRO
RIBOSE_5P	RIBOSE_5P
L_GLUTAMATE_GAMMA_SEMIALDEHYDE	L_GLUTAMATE_GAMMA_SEMIALDEHYDE
DIHYDROLIPOYL_GCVH	DIHYDROLIPOYL_GCVH
tRNA_uridine_38_40	tRNA_uridine_38_40
CPD_8199	CPD_8199
OCTAPRENYL_METHYL_OH_METHOXY_BENZQ	OCTAPRENYL_METHYL_OH_METHOXY_BENZQ
_2_ACETO_2_HYDROXY_BUTYRATE	_2_ACETO_2_HYDROXY_BUTYRATE
PHE	PHE
WATER	WATER
tRNAs	tRNAs
_2_D_THREO_HYDROXY_3_CARBOXY_ISOCAPROATE	_2_D_THREO_HYDROXY_3_CARBOXY_ISOCAPROATE
PRPP	PRPP
ACETALD	ACETALD
S_ACETYLDIHYDROLIPOAMIDE	S_ACETYLDIHYDROLIPOAMIDE
XYLULOSE_5_PHOSPHATE	XYLULOSE_5_PHOSPHATE
MAL	MAL
TYR	TYR
L_CYSTEATE	L_CYSTEATE
D_SEDOHEPTULOSE_7_P	D_SEDOHEPTULOSE_7_P
PROPIONYL_P	PROPIONYL_P
CHORISMATE	CHORISMATE
Charged_LYS_tRNAs	Charged_LYS_tRNAs
ASN_tRNAs	ASN_tRNAs
apolipoprotein	apolipoprotein
HCO3	HCO3
LYS_tRNAs	LYS_tRNAs
Negatively_super_coiled_DNAs	Negatively_super_coiled_DNAs
PROTON	PROTON
Pyruvate_dehydrogenase_lipoate	Pyruvate_dehydrogenase_lipoate
Charged_THR_tRNAs	Charged_THR_tRNAs
ETOH	ETOH
TYR_tRNAs	TYR_tRNAs
CPD_7046	CPD_7046
Pi	Pi
ADENOSINE5TRIPHOSPHO5ADENOSINE	ADENOSINE5TRIPHOSPHO5ADENOSINE
CPD_8200	CPD_8200
Charged_GLT_tRNAs	Charged_GLT_tRNAs
_1_KETO_2_METHYLVALERATE	_1_KETO_2_METHYLVALERATE
CPD_10227	CPD_10227
LL_DIAMINOPIMELATE	LL_DIAMINOPIMELATE
tRNA_Containing_5MeAminoMe_2_ThioU	tRNA_Containing_5MeAminoMe_2_ThioU
Octanoyl_ACPs	Octanoyl_ACPs
Reduced_NrdH_Proteins	Reduced_NrdH_Proteins
ADENOSYL_P4	ADENOSYL_P4
_16S_rRNA_adenine1518_adenine1519	_16S_rRNA_adenine1518_adenine1519
AMP	AMP
L_ASPARTATE	L_ASPARTATE
OCTAPRENYL_METHYL_METHOXY_BENZQ	OCTAPRENYL_METHYL_METHOXY_BENZQ
NADH_P_OR_NOP	NADH_P_OR_NOP
Charged_SER_tRNAs	Charged_SER_tRNAs
HIS_tRNAs	HIS_tRNAs
Reduced_Quinones	Reduced_Quinones
DIHYDROXY_ACETONE_PHOSPHATE	DIHYDROXY_ACETONE_PHOSPHATE
_2_O_Methylguanosine18	_2_O_Methylguanosine18
N_SUCCINYLLL_2_6_DIAMINOPIMELATE	N_SUCCINYLLL_2_6_DIAMINOPIMELATE
CPD_13205	CPD_13205
TRP_tRNAs	TRP_tRNAs
L_SELENOCYSTEINE	L_SELENOCYSTEINE
D_SEDOHEPTULOSE_1_7_P2	D_SEDOHEPTULOSE_1_7_P2
BCAA_dehydrogenase_DH_lipoyl	BCAA_dehydrogenase_DH_lipoyl
_2_OXOBUTANOATE	_2_OXOBUTANOATE
E_	E_
DELTA3_ISOPENTENYL_PP	DELTA3_ISOPENTENYL_PP
TRP	TRP
L_ALPHA_AMINO_EPSILON_KETO_PIMELATE	L_ALPHA_AMINO_EPSILON_KETO_PIMELATE
FRUCTOSE_16_DIPHOSPHATE	FRUCTOSE_16_DIPHOSPHATE
_2_OCTAPRENYL_6_HYDROXYPHENOL	_2_OCTAPRENYL_6_HYDROXYPHENOL
O_UREIDOHOMOSERINE	O_UREIDOHOMOSERINE
Charged_PRO_tRNAs	Charged_PRO_tRNAs
CPD_9451	CPD_9451
PROTEIN_LIPOYLLYSINE	PROTEIN_LIPOYLLYSINE
Charged_GLN_tRNAs	Charged_GLN_tRNAs
_4_PHOSPHONOOXY_THREONINE	_4_PHOSPHONOOXY_THREONINE
OXALO_SUCCINATE	OXALO_SUCCINATE
ADENYLOSUCC	ADENYLOSUCC
_1_4_beta_D_Glucan	_1_4_beta_D_Glucan
DPG	DPG
Charged_MET_tRNAs	Charged_MET_tRNAs
Ox_Thioredoxin	Ox_Thioredoxin
DELTA1_PIPERIDEINE_2_6_DICARBOXYLATE	DELTA1_PIPERIDEINE_2_6_DICARBOXYLATE
Pyruvate_dehydrogenase_acetylDHlipoyl	Pyruvate_dehydrogenase_acetylDHlipoyl
Lipoyl_Protein	Lipoyl_Protein
N_ACETYL_GLUTAMYL_P	N_ACETYL_GLUTAMYL_P
OH	OH
RS_3_Sulfolactate	RS_3_Sulfolactate
AMMONIA	AMMONIA
PHOSPHO_ENOL_PYRUVATE	PHOSPHO_ENOL_PYRUVATE
Oxidized_flavodoxins	Oxidized_flavodoxins
NADH	NADH
SUC	SUC
GLN	GLN
Donor_H2	Donor_H2
Reduced_flavodoxins	Reduced_flavodoxins
PHENYL_PYRUVATE	PHENYL_PYRUVATE
GLC	GLC
L_ARGININO_SUCCINATE	L_ARGININO_SUCCINATE
Charged_ARG_tRNAs	Charged_ARG_tRNAs
_2_KETOGLUTARATE	_2_KETOGLUTARATE
Lipoylated_domains	Lipoylated_domains
GLY	GLY
MET_tRNAs	MET_tRNAs
ACP	ACP
ATP	ATP
L_1_PHOSPHATIDYL_GLYCEROL	L_1_PHOSPHATIDYL_GLYCEROL
Oxo_glutarate_dehydro_suc_DH_lipoyl	Oxo_glutarate_dehydro_suc_DH_lipoyl
NADP	NADP
GLT	GLT
General_Protein_Substrates	General_Protein_Substrates
SHIKIMATE_5P	SHIKIMATE_5P
SER	SER
Charged_GLY_tRNAs	Charged_GLY_tRNAs
Charged_HIS_tRNAs	Charged_HIS_tRNAs
Charged_TYR_tRNAs	Charged_TYR_tRNAs
Charged_ILE_tRNAs	Charged_ILE_tRNAs
LEU_tRNAs	LEU_tRNAs
Supercoiled_Duplex_DNAs	Supercoiled_Duplex_DNAs
INDOLE_3_GLYCEROL_P	INDOLE_3_GLYCEROL_P
GLC_6_P	GLC_6_P
Peptides_with_Leader_Sequence	Peptides_with_Leader_Sequence
L_CANALINE	L_CANALINE
Cytochromes_C_Oxidized	Cytochromes_C_Oxidized
Cytochromes_C_Reduced	Cytochromes_C_Reduced
ASN	ASN
Acceptor	Acceptor
CPD0_2472	CPD0_2472
Relaxed_DNAs	Relaxed_DNAs
FRUCTOSE_6P	FRUCTOSE_6P
ADP	ADP
Charged_LEU_tRNAs	Charged_LEU_tRNAs
L_DELTA1_PYRROLINE_5_CARBOXYLATE	L_DELTA1_PYRROLINE_5_CARBOXYLATE
_2K_4CH3_PENTANOATE	_2K_4CH3_PENTANOATE
Charged_CYS_tRNAs	Charged_CYS_tRNAs
PYRUVATE	PYRUVATE
HYDROGEN_MOLECULE	HYDROGEN_MOLECULE
_2_ACETO_LACTATE	_2_ACETO_LACTATE
NADPH	NADPH
IMP	IMP
ARABINOSE_5P	ARABINOSE_5P
CPD0_2351	CPD0_2351
_3_DEOXY_D_ARABINO_HEPTULOSONATE_7_P	_3_DEOXY_D_ARABINO_HEPTULOSONATE_7_P
Charged_PHE_tRNAs	Charged_PHE_tRNAs
KDO_8P	KDO_8P
CANAVANINOSUCCINATE	CANAVANINOSUCCINATE
SN_GLYCEROL_1_PHOSPHATE	SN_GLYCEROL_1_PHOSPHATE
CARBON_DIOXIDE	CARBON_DIOXIDE
GDP	GDP
INDOLE	INDOLE
Charged_ASN_tRNAs	Charged_ASN_tRNAs
PHE_tRNAs	PHE_tRNAs
RIBULOSE_5P	RIBULOSE_5P
MESO_DIAMINOPIMELATE	MESO_DIAMINOPIMELATE
_2_3_DIHYDRODIPICOLINATE	_2_3_DIHYDRODIPICOLINATE
CELLULOSE	CELLULOSE
HOMO_SER	HOMO_SER
DIACETYL	DIACETYL
CPD_10226	CPD_10226
MET	MET
Lysidine_tRNA_Ile2	Lysidine_tRNA_Ile2
L_ASPARTATE_SEMIALDEHYDE	L_ASPARTATE_SEMIALDEHYDE
LEU	LEU
ERYTHROSE_4P	ERYTHROSE_4P
_4_hydroxybenzoate	_4_hydroxybenzoate
Single_Stranded_DNAs	Single_Stranded_DNAs
CPD0_2353	CPD0_2353
THREO_DS_ISO_CITRATE	THREO_DS_ISO_CITRATE
CELLOBIOSE	CELLOBIOSE
O_PHOSPHO_L_HOMOSERINE	O_PHOSPHO_L_HOMOSERINE
Prolipoproteins	Prolipoproteins
ASP_tRNAs	ASP_tRNAs
Nucleoside_Monophosphates	Nucleoside_Monophosphates
_2_KETO_ISOVALERATE	_2_KETO_ISOVALERATE
CARBOXYPHENYLAMINO_DEOXYRIBULOSE_P	CARBOXYPHENYLAMINO_DEOXYRIBULOSE_P
THIAMINE_PYROPHOSPHATE	THIAMINE_PYROPHOSPHATE
Cellodextrins	Cellodextrins
CPD0_2354	CPD0_2354
OXALACETIC_ACID	OXALACETIC_ACID
DATP	DATP
GLC_1_P	GLC_1_P
CPD0_2350	CPD0_2350
L_ORNITHINE	L_ORNITHINE
N_5_PHOSPHORIBOSYL_ANTHRANILATE	N_5_PHOSPHORIBOSYL_ANTHRANILATE
PROPIONATE	PROPIONATE
DNA_N	DNA_N
CIT	CIT
DEHYDROQUINATE	DEHYDROQUINATE
GLT_tRNAs	GLT_tRNAs
ARG_tRNAs	ARG_tRNAs
Diacylglycerol_Prolipoproteins	Diacylglycerol_Prolipoproteins
FARNESYL_PP	FARNESYL_PP
CAFFEOYL_COA	CAFFEOYL_COA
HIS	HIS
_3_OCTAPRENYL_4_HYDROXYBENZOATE	_3_OCTAPRENYL_4_HYDROXYBENZOATE
VAL	VAL
L_ALPHA_ALANINE	L_ALPHA_ALANINE
S_ADENOSYLMETHIONINE	S_ADENOSYLMETHIONINE
ALPHA_GLUCOSE	ALPHA_GLUCOSE
PPI	PPI
_3_ENOLPYRUVYL_SHIKIMATE_5P	_3_ENOLPYRUVYL_SHIKIMATE_5P
_2_PG	_2_PG
Nucleoside_Triphosphates	Nucleoside_Triphosphates
_3_DEHYDRO_SHIKIMATE	_3_DEHYDRO_SHIKIMATE
RNA_Holder	RNA_Holder
PRO_tRNAs	PRO_tRNAs
CH33ADO	CH33ADO
_2_OCTAPRENYLPHENOL	_2_OCTAPRENYLPHENOL
FERULOYL_COA	FERULOYL_COA
Charged_ALA_tRNAs	Charged_ALA_tRNAs
CYS	CYS
_2_OCTAPRENYL_6_METHOXYPHENOL	_2_OCTAPRENYL_6_METHOXYPHENOL
Charged_TRP_tRNAs	Charged_TRP_tRNAs
CPD0_2189	CPD0_2189
CPD_9956	CPD_9956
G3P	G3P
CARBAMOYL_P	CARBAMOYL_P
Nucleoside_Diphosphates	Nucleoside_Diphosphates
L_CITRULLINE	L_CITRULLINE
GLN_tRNAs	GLN_tRNAs
CPD_469	CPD_469
Apo_GcvH	Apo_GcvH
Leader_Sequences	Leader_Sequences
SO3	SO3
Dihydro_Lipoyl_Proteins	Dihydro_Lipoyl_Proteins
PREPHENATE	PREPHENATE
tRNA_Holder	tRNA_Holder
SEC_tRNAs	SEC_tRNAs
Lipoyl_ACPs	Lipoyl_ACPs
_2_ALPHA_HYDROXYETHYL_THPP	_2_ALPHA_HYDROXYETHYL_THPP
Quinones	Quinones
SER_tRNAs	SER_tRNAs
N_ALPHA_ACETYLORNITHINE	N_ALPHA_ACETYLORNITHINE
GTP	GTP
NAD_P_OR_NOP	NAD_P_OR_NOP
Ubiquinols	Ubiquinols
Ribonucleoside_Monophosphates	Ribonucleoside_Monophosphates
DIHYDROLIPOAMIDE	DIHYDROLIPOAMIDE
Peptides	Peptides
Oxo_glutarate_dehydrogenase_DH_lipoyl	Oxo_glutarate_dehydrogenase_DH_lipoyl
Non_lipoylated_domains	Non_lipoylated_domains
ARG	ARG
LIPOAMIDE	LIPOAMIDE
L_seryl_SEC_tRNAs	L_seryl_SEC_tRNAs
tRNAs_with_CCA	tRNAs_with_CCA
signal_peptide	signal_peptide
DADP	DADP
Pyruvate_dehydrogenase_dihydrolipoate	Pyruvate_dehydrogenase_dihydrolipoate
_2_KETO_3_METHYL_VALERATE	_2_KETO_3_METHYL_VALERATE
